111111111111111111
100000000000000001
100000000000000001
100011110000000001
100000000000000001
100000000110000001
100000000000010001
100010000000000001
100100000001110001
100000001100000001
100100000000010001
100111100000000001
100000000000000001
100000000000111101
100101110000000001
100001000000000001
100000000000000001
111111111111111111