111111111111111111111111111111111
100000000000000000000000000000001
100001111111111000000000000000001
100001000000000000000000000000001
100001000000000000000000000000001
100001000000000000000000000000001
100000000000000000000000000000001
100000000000000000000000000000001
100000000000000000000000000000001
100000000000000000000000000000001
100000000000000000000000000000001
100000000000000000000000000000001
100111110000000000000000000000001
100100000000000000000000000000001
100100000000000000000000000000001
100100000000000001111111111100001
100100000000000000000000000100001
100000000000000000000000000100001
100000000000000000000000000100001
100000000000000000000000000000001
100000000000000000000000000000001
100000000000000000000000000000001
100000000000001000000000000000001
100000000000001000000000000000001
100000000000001000000000000000001
100000000000001000000000000000001
100000000000001000000000000000001
100000011111111000000000000000001
100000000000000000000000000000001
100000000000000000000000000000001
100000000000000000000000000000001
100000000000000000000000000000001
111111111111111111111111111111111